#############
#gAW g# g  A#
#### ## #####
#A    @ #gW #
#W##### ### #
#    g#     #
#############